x x x x x x x x x x x x x x x 
x o x x o o x o o o o o o o z 
x o o x x o x x x o x x x x x 
x x o x o o o z x o o o o x x 
x o o x x x x 2 x o x x x x x 
x x x x o o o o x o o o o o x 
x x o x x x x 3 x x x o x o x 
x o o o o o o s x x x o x x x 
x o x x o x x o o o o o o o x 
x o o x o x x x x o x x x x x 
x x o x o o o o x o o o o o x 
x o o x x x x o x o x x x x x 
x o x x o o o o x o o o o o x 
x o x o o x x o x o x o x o x 
x x x x x x x x x x x x x x x 
